WWWWWWWWWWWWWWWW
W    FFF   WWWFW
WWWWWDWWW   F FW
W  P  WWWDDDDDDW
WWWWWWWWW  G F W
W FF      F F FW
WDWWWWWWWDDDDDDW
W  F D     FFF W
W   DD   G  FF W
WDWWD       F  W
W   DDDWWWDWWWWW
W      WFFFFF  W
W  FF  WWWWWW GW
W  FF  D       W
W      WWWWWWWWW
WWWWWWWWWWWWWWWW
