Wwwwwwwwwwwwwwww
w    FFF   WWWFW
WWWWWWWWW   F RW
W  P  WWWRRRRRRW
WWWWWRWWW  G F W
W FF      F F FW
WWWWWWWWWRRRRRRW
W  F R     FFF W
W   RR   G  FF W
WRWWR       F  W
W   RRRWWWWWWWWW
W      WFFFFF  W
W  FF  WWWWWW GW
W  FF  R       W
W      WWWWWWWWW
WWWWWWWWWWWWWWWW
